_,_ _,_ _,_ 1,e _,_ _,_ _,_
_,_ _,_ 1,e _,_ 1,e _,_ _,_
_,_ 1,e _,_ _,_ _,_ 1,e _,_
_,_ _,_ 1,e _,_ 1,e _,_ _,_
_,_ _,_ _,_ 1,e _,_ _,_ _,_
2,e _,_ _,_ _,_ _,_ _,_ 2,e
_,_ _,_ 1,e _,_ 1,e _,_ _,_
_,_ 1,e _,_ _,_ _,_ 1,e _,_
_,_ 1,e _,_ 1,e _,_ _,_ _,_
_,_ _,_ _,_ _,_ 1,e 1,e _,_
_,_ _,_ _,_ 1,e _,_ _,_ _,_
_,_ _,_ 1,e _,_ 1,e _,_ _,_
_,_ 1,e _,_ _,_ _,_ 1,e _,_
_,_ _,_ 1,e _,_ 1,e _,_ _,_
_,_ _,_ _,_ 1,e _,_ _,_ _,_
2,e _,_ _,_ _,_ _,_ _,_ 2,e
_,_ _,_ 1,e _,_ 1,e _,_ _,_
_,_ 1,e _,_ _,_ _,_ 1,e _,_
_,_ 1,e _,_ 1,e _,_ _,_ _,_
_,_ _,_ _,_ _,_ 1,e 1,e _,_
_,_ _,_ _,_ 1,e _,_ _,_ _,_
_,_ _,_ _,_ 1,e _,_ _,_ _,_
_,_ _,_ _,_ 1,e _,_ _,_ _,_
_,_ _,_ _,_ 1,e _,_ _,_ _,_
_,_ _,_ _,_ 1,e _,_ _,_ _,_